roll_no,gender,race,parental level of education,lunch,test preparation course,math score,reading score,writing score,total
1,female,group B,bachelor's degree,standard,none,72,72,74,218
2,female,group C,some college,standard,completed,69,90,88,247
3,female,group B,master's degree,standard,none,90,95,93,278
4,male,group A,associate's degree,free/reduced,none,47,57,44,148
5,male,group C,some college,standard,none,76,78,75,229
6,female,group B,associate's degree,standard,none,71,83,78,232
7,female,group B,some college,standard,completed,88,95,92,275
8,male,group B,some college,free/reduced,none,40,43,39,122
9,male,group D,high school,free/reduced,completed,64,64,67,195
10,female,group B,high school,free/reduced,none,38,60,50,148
11,male,group C,associate's degree,standard,none,58,54,52,164
12,male,group D,associate's degree,standard,none,40,52,43,135
13,female,group B,high school,standard,none,65,81,73,219
14,male,group A,some college,standard,completed,78,72,70,220
15,female,group A,master's degree,standard,none,50,53,58,161
16,female,group C,some high school,standard,none,69,75,78,222
17,male,group C,high school,standard,none,88,89,86,263
18,female,group B,some high school,free/reduced,none,18,32,28,78
19,male,group C,master's degree,free/reduced,completed,46,42,46,134
20,female,group C,associate's degree,free/reduced,none,54,58,61,173
21,male,group D,high school,standard,none,66,69,63,198
22,female,group B,some college,free/reduced,completed,65,75,70,210
23,male,group D,some college,standard,none,44,54,53,151
24,female,group C,some high school,standard,none,69,73,73,215
25,male,group D,bachelor's degree,free/reduced,completed,74,71,80,225
26,male,group A,master's degree,free/reduced,none,73,74,72,219
27,male,group B,some college,standard,none,69,54,55,178
28,female,group C,bachelor's degree,standard,none,67,69,75,211
29,male,group C,high school,standard,none,70,70,65,205
30,female,group D,master's degree,standard,none,62,70,75,207
31,female,group D,some college,standard,none,69,74,74,217
32,female,group B,some college,standard,none,63,65,61,189
33,female,group E,master's degree,free/reduced,none,56,72,65,193
34,male,group D,some college,standard,none,40,42,38,120
35,male,group E,some college,standard,none,97,87,82,266
36,male,group E,associate's degree,standard,completed,81,81,79,241
37,female,group D,associate's degree,standard,none,74,81,83,238
38,female,group D,some high school,free/reduced,none,50,64,59,173
39,female,group D,associate's degree,free/reduced,completed,75,90,88,253
40,male,group B,associate's degree,free/reduced,none,57,56,57,170
41,male,group C,associate's degree,free/reduced,none,55,61,54,170
42,female,group C,associate's degree,standard,none,58,73,68,199
43,female,group B,associate's degree,standard,none,53,58,65,176
44,male,group B,some college,free/reduced,completed,59,65,66,190
45,female,group E,associate's degree,free/reduced,none,50,56,54,160
46,male,group B,associate's degree,standard,none,65,54,57,176
47,female,group A,associate's degree,standard,completed,55,65,62,182
48,female,group C,high school,standard,none,66,71,76,213
49,female,group D,associate's degree,free/reduced,completed,57,74,76,207
50,male,group C,high school,standard,completed,82,84,82,248
51,male,group E,some college,standard,none,53,55,48,156
52,male,group E,associate's degree,free/reduced,completed,77,69,68,214
53,male,group C,some college,standard,none,53,44,42,139
54,male,group D,high school,standard,none,88,78,75,241
55,female,group C,some high school,free/reduced,completed,71,84,87,242
56,female,group C,high school,free/reduced,none,33,41,43,117
57,female,group E,associate's degree,standard,completed,82,85,86,253
58,male,group D,associate's degree,standard,none,52,55,49,156
59,male,group D,some college,standard,completed,58,59,58,175
60,female,group C,some high school,free/reduced,none,0,17,10,27
61,male,group E,bachelor's degree,free/reduced,completed,79,74,72,225
62,male,group A,some high school,free/reduced,none,39,39,34,112
63,male,group A,associate's degree,free/reduced,none,62,61,55,178
64,female,group C,associate's degree,standard,none,69,80,71,220
65,female,group D,some high school,standard,none,59,58,59,176
66,male,group B,some high school,standard,none,67,64,61,192
67,male,group D,some high school,free/reduced,none,45,37,37,119
68,female,group C,some college,standard,none,60,72,74,206
69,male,group B,associate's degree,free/reduced,none,61,58,56,175
70,female,group C,associate's degree,standard,none,39,64,57,160
71,female,group D,some college,free/reduced,completed,58,63,73,194
72,male,group D,some college,standard,completed,63,55,63,181
73,female,group A,associate's degree,free/reduced,none,41,51,48,140
74,male,group C,some high school,free/reduced,none,61,57,56,174
75,male,group C,some high school,standard,none,49,49,41,139
76,male,group B,associate's degree,free/reduced,none,44,41,38,123
77,male,group E,some high school,standard,none,30,26,22,78
78,male,group A,bachelor's degree,standard,completed,80,78,81,239
79,female,group D,some high school,standard,completed,61,74,72,207
80,female,group E,master's degree,standard,none,62,68,68,198
81,female,group B,associate's degree,standard,none,47,49,50,146
82,male,group B,high school,free/reduced,none,49,45,45,139
83,male,group A,some college,free/reduced,completed,50,47,54,151
84,male,group E,associate's degree,standard,none,72,64,63,199
85,male,group D,high school,free/reduced,none,42,39,34,115
86,female,group C,some college,standard,none,73,80,82,235
87,female,group C,some college,free/reduced,none,76,83,88,247
88,female,group D,associate's degree,standard,none,71,71,74,216
89,female,group A,some college,standard,none,58,70,67,195
90,female,group D,some high school,standard,none,73,86,82,241
91,female,group C,bachelor's degree,standard,none,65,72,74,211
92,male,group C,high school,free/reduced,none,27,34,36,97
93,male,group C,high school,standard,none,71,79,71,221
94,male,group C,associate's degree,free/reduced,completed,43,45,50,138
95,female,group B,some college,standard,none,79,86,92,257
96,male,group C,associate's degree,free/reduced,completed,78,81,82,241
97,male,group B,some high school,standard,completed,65,66,62,193
98,female,group E,some college,standard,completed,63,72,70,205
99,female,group D,some college,free/reduced,none,58,67,62,187
100,female,group D,bachelor's degree,standard,none,65,67,62,194
101,male,group B,some college,standard,none,79,67,67,213
102,male,group D,bachelor's degree,standard,completed,68,74,74,216
103,female,group D,associate's degree,standard,none,85,91,89,265
104,male,group B,high school,standard,completed,60,44,47,151
105,male,group C,some college,standard,completed,98,86,90,274
106,female,group C,some college,standard,none,58,67,72,197
107,female,group D,master's degree,standard,none,87,100,100,287
108,male,group E,associate's degree,standard,completed,66,63,64,193
109,female,group B,associate's degree,free/reduced,none,52,76,70,198
110,female,group B,some high school,standard,none,70,64,72,206
111,female,group D,associate's degree,free/reduced,completed,77,89,98,264
112,male,group C,high school,standard,none,62,55,49,166
113,male,group A,associate's degree,standard,none,54,53,47,154
114,female,group D,some college,standard,none,51,58,54,163
115,female,group E,bachelor's degree,standard,completed,99,100,100,299
116,male,group C,high school,standard,none,84,77,74,235
117,female,group B,bachelor's degree,free/reduced,none,75,85,82,242
118,female,group D,bachelor's degree,standard,none,78,82,79,239
119,female,group D,some high school,standard,none,51,63,61,175
120,female,group C,some college,standard,none,55,69,65,189
121,female,group C,bachelor's degree,standard,completed,79,92,89,260
122,male,group B,associate's degree,standard,completed,91,89,92,272
123,female,group C,some college,standard,completed,88,93,93,274
124,male,group D,high school,free/reduced,none,63,57,56,176
125,male,group E,some college,standard,none,83,80,73,236
126,female,group B,high school,standard,none,87,95,86,268
127,male,group B,some high school,standard,none,72,68,67,207
128,male,group D,some college,standard,completed,65,77,74,216
129,male,group D,master's degree,standard,none,82,82,74,238
130,female,group A,bachelor's degree,standard,none,51,49,51,151
131,male,group D,master's degree,standard,none,89,84,82,255
132,male,group C,some high school,free/reduced,completed,53,37,40,130
133,male,group E,some college,free/reduced,completed,87,74,70,231
134,female,group C,some college,standard,completed,75,81,84,240
135,male,group D,bachelor's degree,free/reduced,completed,74,79,75,228
136,male,group C,bachelor's degree,standard,none,58,55,48,161
137,male,group B,some high school,standard,completed,51,54,41,146
138,male,group E,high school,standard,none,70,55,56,181
139,female,group C,associate's degree,standard,none,59,66,67,192
140,male,group D,some college,standard,completed,71,61,69,201
141,female,group D,some high school,standard,none,76,72,71,219
142,female,group C,some college,free/reduced,none,59,62,64,185
143,female,group E,some college,free/reduced,completed,42,55,54,151
144,male,group A,high school,standard,none,57,43,47,147
145,male,group D,some college,standard,none,88,73,78,239
146,female,group C,some college,free/reduced,none,22,39,33,94
147,male,group B,some high school,standard,none,88,84,75,247
148,male,group C,associate's degree,free/reduced,none,73,68,66,207
149,female,group D,bachelor's degree,standard,completed,68,75,81,224
150,male,group E,associate's degree,free/reduced,completed,100,100,93,293
151,male,group A,some high school,standard,completed,62,67,69,198
152,male,group A,bachelor's degree,standard,none,77,67,68,212
153,female,group B,associate's degree,standard,completed,59,70,66,195
154,male,group D,bachelor's degree,standard,none,54,49,47,150
155,male,group D,some high school,standard,none,62,67,61,190
156,female,group C,some college,standard,completed,70,89,88,247
157,female,group E,high school,free/reduced,completed,66,74,78,218
158,male,group B,some college,free/reduced,none,60,60,60,180
159,female,group B,associate's degree,standard,completed,61,86,87,234
160,male,group D,associate's degree,free/reduced,none,66,62,64,192
161,male,group B,associate's degree,free/reduced,completed,82,78,74,234
162,female,group E,some college,free/reduced,completed,75,88,85,248
163,male,group B,master's degree,free/reduced,none,49,53,52,154
164,male,group C,high school,standard,none,52,53,49,154
165,female,group E,master's degree,standard,none,81,92,91,264
166,female,group C,bachelor's degree,standard,completed,96,100,100,296
167,male,group C,high school,free/reduced,completed,53,51,51,155
168,female,group B,master's degree,free/reduced,completed,58,76,78,212
169,female,group B,high school,standard,completed,68,83,78,229
170,female,group C,some college,free/reduced,completed,67,75,70,212
171,male,group A,high school,standard,completed,72,73,74,219
172,male,group E,some high school,standard,none,94,88,78,260
173,female,group D,some college,standard,none,79,86,81,246
174,female,group C,associate's degree,standard,none,63,67,70,200
175,female,group C,bachelor's degree,free/reduced,completed,43,51,54,148
176,female,group C,master's degree,standard,completed,81,91,87,259
177,female,group B,high school,free/reduced,completed,46,54,58,158
178,female,group C,associate's degree,standard,completed,71,77,77,225
179,female,group B,master's degree,free/reduced,completed,52,70,62,184
180,female,group D,some high school,standard,completed,97,100,100,297
181,male,group C,master's degree,free/reduced,completed,62,68,75,205
182,female,group C,some college,free/reduced,none,46,64,66,176
183,female,group E,high school,standard,none,50,50,47,147
184,female,group D,associate's degree,standard,none,65,69,70,204
185,male,group C,some high school,free/reduced,completed,45,52,49,146
186,male,group C,associate's degree,free/reduced,completed,65,67,65,197
187,male,group E,high school,standard,none,80,76,65,221
188,male,group D,some high school,standard,completed,62,66,68,196
189,male,group B,some high school,free/reduced,none,48,52,45,145
190,female,group C,bachelor's degree,standard,none,77,88,87,252
191,female,group E,associate's degree,standard,none,66,65,69,200
192,male,group D,some college,standard,completed,76,83,79,238
193,female,group B,some high school,standard,none,62,64,66,192
194,male,group D,some college,standard,completed,77,62,62,201
195,female,group C,master's degree,standard,completed,69,84,85,238
196,male,group D,associate's degree,standard,none,61,55,52,168
197,male,group C,some high school,free/reduced,completed,59,69,65,193
198,male,group E,high school,free/reduced,none,55,56,51,162
199,female,group B,some college,free/reduced,none,45,53,55,153
200,female,group B,bachelor's degree,free/reduced,none,78,79,76,233
201,female,group C,associate's degree,standard,completed,67,84,86,237
202,female,group D,some college,free/reduced,none,65,81,77,223
203,male,group C,associate's degree,standard,none,69,77,69,215
204,female,group B,associate's degree,standard,none,57,69,68,194
205,male,group C,some college,standard,none,59,41,42,142
206,male,group D,some high school,standard,completed,74,71,78,223
207,male,group E,bachelor's degree,standard,none,82,62,62,206
208,male,group E,high school,standard,completed,81,80,76,237
209,female,group B,some college,free/reduced,none,74,81,76,231
210,female,group B,some college,free/reduced,none,58,61,66,185
211,male,group D,some high school,free/reduced,completed,80,79,79,238
212,male,group C,some college,free/reduced,none,35,28,27,90
213,female,group C,high school,free/reduced,none,42,62,60,164
214,male,group C,associate's degree,free/reduced,completed,60,51,56,167
215,male,group E,high school,standard,completed,87,91,81,259
216,male,group B,some high school,standard,completed,84,83,75,242
217,female,group E,associate's degree,free/reduced,completed,83,86,88,257
218,female,group C,high school,free/reduced,none,34,42,39,115
219,male,group B,high school,free/reduced,none,66,77,70,213
220,male,group B,some high school,standard,completed,61,56,56,173
221,female,group D,high school,standard,completed,56,68,74,198
222,male,group B,associate's degree,standard,none,87,85,73,245
223,female,group C,some high school,free/reduced,none,55,65,62,182
224,male,group D,some high school,standard,none,86,80,75,241
225,female,group B,associate's degree,standard,completed,52,66,73,191
226,female,group E,master's degree,free/reduced,none,45,56,54,155
227,female,group C,some college,standard,none,72,72,71,215
228,male,group D,high school,standard,none,57,50,54,161
229,male,group A,some high school,free/reduced,none,68,72,64,204
230,female,group C,some college,standard,completed,88,95,94,277
231,male,group D,some college,standard,none,76,64,66,206
232,male,group C,associate's degree,standard,none,46,43,42,131
233,female,group B,bachelor's degree,standard,none,67,86,83,236
234,male,group E,some high school,standard,none,92,87,78,257
235,male,group C,bachelor's degree,standard,completed,83,82,84,249
236,male,group D,associate's degree,standard,none,80,75,77,232
237,male,group D,bachelor's degree,free/reduced,none,63,66,67,196
238,female,group D,some high school,standard,completed,64,60,74,198
239,male,group B,some college,standard,none,54,52,51,157
240,male,group C,associate's degree,standard,none,84,80,80,244
241,male,group D,high school,free/reduced,completed,73,68,66,207
242,female,group E,bachelor's degree,standard,none,80,83,83,246
243,female,group D,high school,standard,none,56,52,55,163
244,male,group E,some college,standard,none,59,51,43,153
245,male,group D,some high school,standard,none,75,74,69,218
246,male,group C,associate's degree,standard,none,85,76,71,232
247,male,group E,associate's degree,standard,none,89,76,74,239
248,female,group B,high school,standard,completed,58,70,68,196
249,female,group B,high school,standard,none,65,64,62,191
250,male,group C,high school,standard,none,68,60,53,181
251,male,group A,some high school,standard,completed,47,49,49,145
252,female,group D,some college,free/reduced,none,71,83,83,237
253,female,group B,some high school,standard,completed,60,70,70,200
254,male,group D,master's degree,standard,none,80,80,72,232
255,male,group D,high school,standard,none,54,52,52,158
256,female,group E,some college,standard,none,62,73,70,205
257,female,group C,associate's degree,free/reduced,none,64,73,68,205
258,male,group C,associate's degree,standard,completed,78,77,77,232
259,female,group B,some college,standard,none,70,75,78,223
260,female,group C,master's degree,free/reduced,completed,65,81,81,227
261,female,group C,some high school,free/reduced,completed,64,79,77,220
262,male,group C,some college,standard,completed,79,79,78,236
263,female,group C,some high school,free/reduced,none,44,50,51,145
264,female,group E,high school,standard,none,99,93,90,282
265,male,group D,high school,standard,none,76,73,68,217
266,male,group D,some high school,free/reduced,none,59,42,41,142
267,female,group C,bachelor's degree,standard,none,63,75,81,219
268,female,group D,high school,standard,none,69,72,77,218
269,female,group D,associate's degree,standard,completed,88,92,95,275
270,female,group E,some college,free/reduced,none,71,76,70,217
271,male,group C,bachelor's degree,standard,none,69,63,61,193
272,male,group C,some college,standard,none,58,49,42,149
273,female,group D,associate's degree,free/reduced,none,47,53,58,158
274,female,group D,some college,standard,none,65,70,71,206
275,male,group B,some college,standard,completed,88,85,76,249
276,male,group C,bachelor's degree,standard,none,83,78,73,234
277,female,group C,some high school,standard,completed,85,92,93,270
278,female,group E,high school,standard,completed,59,63,75,197
279,female,group C,some high school,free/reduced,none,65,86,80,231
280,male,group B,bachelor's degree,free/reduced,none,73,56,57,186
281,male,group D,high school,standard,none,53,52,42,147
282,male,group D,high school,standard,none,45,48,46,139
283,female,group D,bachelor's degree,free/reduced,none,73,79,84,236
284,female,group D,some college,free/reduced,completed,70,78,78,226
285,female,group B,some high school,standard,none,37,46,46,129
286,male,group B,associate's degree,standard,completed,81,82,82,245
287,male,group E,associate's degree,standard,completed,97,82,88,267
288,female,group B,some high school,standard,none,67,89,82,238
289,male,group B,bachelor's degree,free/reduced,none,88,75,76,239
290,male,group E,some high school,standard,completed,77,76,77,230
291,male,group C,associate's degree,standard,none,76,70,68,214
292,male,group D,some high school,standard,none,86,73,70,229
293,male,group C,some high school,standard,completed,63,60,57,180
294,female,group E,bachelor's degree,standard,none,65,73,75,213
295,male,group D,high school,free/reduced,completed,78,77,80,235
296,male,group B,associate's degree,free/reduced,none,67,62,60,189
297,male,group A,some high school,standard,completed,46,41,43,130
298,male,group E,associate's degree,standard,completed,71,74,68,213
299,male,group C,high school,free/reduced,completed,40,46,50,136
300,male,group D,associate's degree,free/reduced,none,90,87,75,252
301,male,group A,some college,free/reduced,completed,81,78,81,240
302,male,group D,some high school,free/reduced,none,56,54,52,162
303,female,group C,associate's degree,standard,completed,67,84,81,232
304,male,group B,associate's degree,standard,none,80,76,64,220
305,female,group C,associate's degree,standard,completed,74,75,83,232
306,male,group A,some college,standard,none,69,67,69,205
307,male,group E,some college,standard,completed,99,87,81,267
308,male,group C,some high school,standard,none,51,52,44,147
309,female,group B,associate's degree,free/reduced,none,53,71,67,191
310,female,group D,high school,free/reduced,none,49,57,52,158
311,female,group B,associate's degree,standard,none,73,76,80,229
312,male,group B,bachelor's degree,standard,none,66,60,57,183
313,male,group D,bachelor's degree,standard,completed,67,61,68,196
314,female,group C,associate's degree,free/reduced,completed,68,67,69,204
315,female,group C,bachelor's degree,standard,completed,59,64,75,198
316,male,group C,high school,standard,none,71,66,65,202
317,female,group D,master's degree,standard,completed,77,82,91,250
318,male,group C,associate's degree,standard,none,83,72,78,233
319,male,group B,bachelor's degree,standard,none,63,71,69,203
320,female,group D,associate's degree,free/reduced,none,56,65,63,184
321,female,group C,high school,free/reduced,completed,67,79,84,230
322,female,group E,high school,standard,none,75,86,79,240
323,female,group C,some college,standard,none,71,81,80,232
324,female,group C,some high school,free/reduced,none,43,53,53,149
325,female,group C,high school,free/reduced,none,41,46,43,130
326,female,group C,some college,standard,none,82,90,94,266
327,male,group C,some college,standard,none,61,61,62,184
328,male,group A,some college,free/reduced,none,28,23,19,70
329,male,group C,associate's degree,standard,completed,82,75,77,234
330,female,group B,some high school,standard,none,41,55,51,147
331,male,group C,high school,standard,none,71,60,61,192
332,male,group C,associate's degree,standard,none,47,37,35,119
333,male,group E,associate's degree,standard,completed,62,56,53,171
334,male,group B,associate's degree,standard,none,90,78,81,249
335,female,group C,bachelor's degree,standard,none,83,93,95,271
336,female,group B,some college,free/reduced,none,61,68,66,195
337,male,group D,some high school,standard,completed,76,70,69,215
338,male,group C,associate's degree,standard,none,49,51,43,143
339,female,group B,some high school,free/reduced,none,24,38,27,89
340,female,group D,some high school,free/reduced,completed,35,55,60,150
341,male,group C,high school,free/reduced,none,58,61,52,171
342,female,group C,high school,standard,none,61,73,63,197
343,female,group B,high school,standard,completed,69,76,74,219
344,male,group D,associate's degree,standard,completed,67,72,67,206
345,male,group D,some college,standard,none,79,73,67,219
346,female,group C,high school,standard,none,72,80,75,227
347,male,group B,some college,standard,none,62,61,57,180
348,female,group C,bachelor's degree,standard,completed,77,94,95,266
349,male,group D,high school,free/reduced,none,75,74,66,215
350,male,group E,associate's degree,standard,none,87,74,76,237
351,female,group B,bachelor's degree,standard,none,52,65,69,186
352,male,group E,some college,standard,none,66,57,52,175
353,female,group C,some college,standard,completed,63,78,80,221
354,female,group C,associate's degree,standard,none,46,58,57,161
355,female,group C,some college,standard,none,59,71,70,200
356,female,group B,bachelor's degree,standard,none,61,72,70,203
357,male,group A,associate's degree,standard,none,63,61,61,185
358,female,group C,some college,free/reduced,completed,42,66,69,177
359,male,group D,some college,free/reduced,none,59,62,61,182
360,female,group D,some college,standard,none,80,90,89,259
361,female,group B,high school,standard,none,58,62,59,179
362,male,group B,some high school,standard,completed,85,84,78,247
363,female,group C,some college,standard,none,52,58,58,168
364,female,group D,some high school,free/reduced,none,27,34,32,93
365,male,group C,some college,standard,none,59,60,58,177
366,male,group A,bachelor's degree,free/reduced,completed,49,58,60,167
367,male,group C,high school,standard,completed,69,58,53,180
368,male,group C,bachelor's degree,free/reduced,none,61,66,61,188
369,female,group A,some high school,free/reduced,none,44,64,58,166
370,female,group D,some high school,standard,none,73,84,85,242
371,male,group E,some college,standard,none,84,77,71,232
372,female,group C,some college,free/reduced,completed,45,73,70,188
373,male,group D,some high school,standard,none,74,74,72,220
374,female,group D,some college,standard,completed,82,97,96,275
375,female,group D,bachelor's degree,standard,none,59,70,73,202
376,male,group E,associate's degree,free/reduced,none,46,43,41,130
377,female,group D,some high school,standard,none,80,90,82,252
378,female,group D,master's degree,free/reduced,completed,85,95,100,280
379,female,group A,some high school,standard,none,71,83,77,231
380,male,group A,bachelor's degree,standard,none,66,64,62,192
381,female,group B,associate's degree,standard,none,80,86,83,249
382,male,group C,associate's degree,standard,completed,87,100,95,282
383,male,group C,master's degree,free/reduced,none,79,81,71,231
384,female,group E,some high school,free/reduced,none,38,49,45,132
385,female,group A,some high school,free/reduced,none,38,43,43,124
386,female,group E,some college,standard,none,67,76,75,218
387,female,group E,bachelor's degree,standard,none,64,73,70,207
388,female,group C,associate's degree,free/reduced,none,57,78,67,202
389,female,group D,high school,standard,none,62,64,64,190
390,male,group D,master's degree,standard,none,73,70,75,218
391,male,group E,some high school,free/reduced,completed,73,67,59,199
392,female,group D,some college,standard,none,77,68,77,222
393,male,group E,some college,standard,none,76,67,67,210
394,male,group C,associate's degree,standard,completed,57,54,56,167
395,female,group C,some high school,standard,completed,65,74,77,216
396,male,group A,high school,free/reduced,none,48,45,41,134
397,female,group B,high school,free/reduced,none,50,67,63,180
398,female,group C,associate's degree,standard,none,85,89,95,269
399,male,group B,some high school,standard,none,74,63,57,194
400,male,group D,some high school,standard,none,60,59,54,173
401,female,group C,some high school,standard,completed,59,54,67,180
402,male,group A,some college,standard,none,53,43,43,139
403,female,group A,some college,free/reduced,none,49,65,55,169
404,female,group D,high school,standard,completed,88,99,100,287
405,female,group C,high school,standard,none,54,59,62,175
406,female,group C,some high school,standard,none,63,73,68,204
407,male,group B,associate's degree,standard,completed,65,65,63,193
408,female,group B,associate's degree,standard,none,82,80,77,239
409,female,group D,high school,free/reduced,completed,52,57,56,165
410,male,group D,associate's degree,standard,completed,87,84,85,256
411,female,group D,master's degree,standard,completed,70,71,74,215
412,male,group E,some college,standard,completed,84,83,78,245
413,male,group D,associate's degree,standard,none,71,66,60,197
414,male,group B,some high school,standard,completed,63,67,67,197
415,female,group C,bachelor's degree,free/reduced,completed,51,72,79,202
416,male,group E,high school,standard,none,84,73,69,226
417,male,group C,bachelor's degree,standard,completed,71,74,68,213
418,male,group C,associate's degree,standard,none,74,73,67,214
419,male,group D,some college,standard,none,68,59,62,189
420,male,group E,high school,free/reduced,completed,57,56,54,167
421,female,group C,associate's degree,free/reduced,completed,82,93,93,268
422,female,group D,high school,standard,completed,57,58,64,179
423,female,group D,master's degree,free/reduced,completed,47,58,67,172
424,female,group A,some high school,standard,completed,59,85,80,224
425,male,group B,some college,free/reduced,none,41,39,34,114
426,female,group C,some college,free/reduced,none,62,67,62,191
427,male,group C,bachelor's degree,standard,none,86,83,86,255
428,male,group C,some high school,free/reduced,none,69,71,65,205
429,male,group A,some high school,free/reduced,none,65,59,53,177
430,male,group C,some high school,free/reduced,none,68,63,54,185
431,male,group C,associate's degree,free/reduced,none,64,66,59,189
432,female,group C,high school,standard,none,61,72,70,203
433,male,group C,high school,standard,none,61,56,55,172
434,female,group A,some high school,free/reduced,none,47,59,50,156
435,male,group C,some high school,standard,none,73,66,66,205
436,male,group C,some college,free/reduced,completed,50,48,53,151
437,male,group D,associate's degree,standard,none,75,68,64,207
438,male,group D,associate's degree,free/reduced,none,75,66,73,214
439,male,group C,high school,standard,none,70,56,51,177
440,male,group D,some high school,standard,completed,89,88,82,259
441,female,group C,some college,standard,completed,67,81,79,227
442,female,group D,high school,standard,none,78,81,80,239
443,female,group A,some high school,free/reduced,none,59,73,69,201
444,female,group B,associate's degree,standard,none,73,83,76,232
445,male,group A,some high school,free/reduced,none,79,82,73,234
446,female,group C,some high school,standard,completed,67,74,77,218
447,male,group D,some college,free/reduced,none,69,66,60,195
448,male,group C,high school,standard,completed,86,81,80,247
449,male,group B,high school,standard,none,47,46,42,135
450,male,group B,associate's degree,standard,none,81,73,72,226
451,female,group C,some college,free/reduced,completed,64,85,85,234
452,female,group E,some college,standard,none,100,92,97,289
453,female,group C,associate's degree,free/reduced,none,65,77,74,216
454,male,group C,some college,free/reduced,none,65,58,49,172
455,female,group C,associate's degree,free/reduced,none,53,61,62,176
456,male,group C,bachelor's degree,free/reduced,none,37,56,47,140
457,female,group D,bachelor's degree,standard,none,79,89,89,257
458,male,group D,associate's degree,free/reduced,none,53,54,48,155
459,female,group E,bachelor's degree,standard,none,100,100,100,300
460,male,group B,high school,standard,completed,72,65,68,205
461,male,group C,bachelor's degree,free/reduced,none,53,58,55,166
462,male,group B,some college,free/reduced,none,54,54,45,153
463,female,group E,some college,standard,none,71,70,76,217
464,female,group C,some college,free/reduced,none,77,90,91,258
465,male,group A,bachelor's degree,standard,completed,75,58,62,195
466,female,group C,some college,standard,none,84,87,91,262
467,female,group D,associate's degree,free/reduced,none,26,31,38,95
468,male,group A,high school,free/reduced,completed,72,67,65,204
469,female,group A,high school,free/reduced,completed,77,88,85,250
470,male,group C,some college,standard,none,91,74,76,241
471,female,group C,associate's degree,standard,completed,83,85,90,258
472,female,group C,high school,standard,none,63,69,74,206
473,female,group C,associate's degree,standard,completed,68,86,84,238
474,female,group D,some high school,standard,none,59,67,61,187
475,female,group B,associate's degree,standard,completed,90,90,91,271
476,female,group D,bachelor's degree,standard,completed,71,76,83,230
477,male,group E,bachelor's degree,standard,completed,76,62,66,204
478,male,group D,associate's degree,standard,none,80,68,72,220
479,female,group D,master's degree,standard,none,55,64,70,189
480,male,group E,associate's degree,standard,none,76,71,67,214
481,male,group B,high school,standard,completed,73,71,68,212
482,female,group D,associate's degree,free/reduced,none,52,59,56,167
483,male,group C,some college,free/reduced,none,68,68,61,197
484,male,group A,high school,standard,none,59,52,46,157
485,female,group B,associate's degree,standard,none,49,52,54,155
486,male,group C,high school,standard,none,70,74,71,215
487,male,group D,some college,free/reduced,none,61,47,56,164
488,female,group C,associate's degree,free/reduced,none,60,75,74,209
489,male,group B,some high school,standard,completed,64,53,57,174
490,male,group A,associate's degree,free/reduced,completed,79,82,82,243
491,female,group A,associate's degree,free/reduced,none,65,85,76,226
492,female,group C,associate's degree,standard,none,64,64,70,198
493,female,group C,some college,standard,none,83,83,90,256
494,female,group C,bachelor's degree,standard,none,81,88,90,259
495,female,group B,high school,standard,none,54,64,68,186
496,male,group D,high school,standard,completed,68,64,66,198
497,female,group C,some college,standard,none,54,48,52,154
498,female,group D,some college,free/reduced,completed,59,78,76,213
499,female,group B,some high school,standard,none,66,69,68,203
500,male,group E,some college,standard,none,76,71,72,219
501,female,group D,master's degree,standard,none,74,79,82,235
502,female,group B,associate's degree,standard,completed,94,87,92,273
503,male,group C,some college,free/reduced,none,63,61,54,178
504,female,group E,associate's degree,standard,completed,95,89,92,276
505,female,group D,master's degree,free/reduced,none,40,59,54,153
506,female,group B,some high school,standard,none,82,82,80,244
507,male,group A,high school,standard,none,68,70,66,204
508,male,group B,bachelor's degree,free/reduced,none,55,59,54,168
509,male,group C,master's degree,standard,none,79,78,77,234
510,female,group C,bachelor's degree,standard,none,86,92,87,265
511,male,group D,some college,standard,none,76,71,73,220
512,male,group A,some high school,standard,none,64,50,43,157
513,male,group D,some high school,free/reduced,none,62,49,52,163
514,female,group B,some high school,standard,completed,54,61,62,177
515,female,group B,master's degree,free/reduced,completed,77,97,94,268
516,female,group C,some high school,standard,completed,76,87,85,248
517,female,group D,some college,standard,none,74,89,84,247
518,female,group E,some college,standard,completed,66,74,73,213
519,female,group D,some high school,standard,completed,66,78,78,222
520,female,group B,high school,free/reduced,completed,67,78,79,224
521,male,group D,some college,standard,none,71,49,52,172
522,female,group C,associate's degree,standard,none,91,86,84,261
523,male,group D,bachelor's degree,standard,none,69,58,57,184
524,male,group C,master's degree,free/reduced,none,54,59,50,163
525,male,group C,high school,standard,completed,53,52,49,154
526,male,group E,some college,standard,none,68,60,59,187
527,male,group C,some high school,free/reduced,completed,56,61,60,177
528,female,group C,high school,free/reduced,none,36,53,43,132
529,female,group D,bachelor's degree,free/reduced,none,29,41,47,117
530,female,group C,associate's degree,standard,none,62,74,70,206
531,female,group C,associate's degree,standard,completed,68,67,73,208
532,female,group C,some high school,standard,none,47,54,53,154
533,male,group E,associate's degree,standard,completed,62,61,58,181
534,female,group E,associate's degree,standard,completed,79,88,94,261
535,male,group B,high school,standard,completed,73,69,68,210
536,female,group C,bachelor's degree,free/reduced,completed,66,83,83,232
537,male,group C,associate's degree,standard,completed,51,60,58,169
538,female,group D,high school,standard,none,51,66,62,179
539,male,group E,bachelor's degree,standard,completed,85,66,71,222
540,male,group A,associate's degree,standard,completed,97,92,86,275
541,male,group C,high school,standard,completed,75,69,68,212
542,male,group D,associate's degree,free/reduced,completed,79,82,80,241
543,female,group C,associate's degree,standard,none,81,77,79,237
544,female,group D,associate's degree,standard,none,82,95,89,266
545,female,group D,master's degree,standard,none,64,63,66,193
546,male,group E,some high school,free/reduced,completed,78,83,80,241
547,female,group A,some high school,standard,completed,92,100,97,289
548,male,group C,high school,standard,completed,72,67,64,203
549,female,group C,high school,free/reduced,none,62,67,64,193
550,male,group C,master's degree,standard,none,79,72,69,220
551,male,group C,some high school,free/reduced,none,79,76,65,220
552,male,group B,bachelor's degree,free/reduced,completed,87,90,88,265
553,female,group B,associate's degree,standard,none,40,48,50,138
554,male,group D,some college,free/reduced,none,77,62,64,203
555,male,group E,associate's degree,standard,none,53,45,40,138
556,female,group C,some college,free/reduced,none,32,39,33,104
557,female,group C,associate's degree,standard,completed,55,72,79,206
558,male,group C,master's degree,free/reduced,none,61,67,66,194
559,female,group B,associate's degree,free/reduced,none,53,70,70,193
560,male,group D,some high school,standard,none,73,66,62,201
561,female,group D,some college,standard,completed,74,75,79,228
562,female,group C,some college,standard,none,63,74,74,211
563,male,group C,bachelor's degree,standard,completed,96,90,92,278
564,female,group D,some college,free/reduced,completed,63,80,80,223
565,male,group B,bachelor's degree,free/reduced,none,48,51,46,145
566,male,group B,associate's degree,standard,none,48,43,45,136
567,female,group E,bachelor's degree,free/reduced,completed,92,100,100,292
568,female,group D,master's degree,free/reduced,completed,61,71,78,210
569,male,group B,high school,free/reduced,none,63,48,47,158
570,male,group D,bachelor's degree,free/reduced,none,68,68,67,203
571,male,group B,some college,standard,completed,71,75,70,216
572,male,group A,bachelor's degree,standard,none,91,96,92,279
573,female,group C,some college,standard,none,53,62,56,171
574,female,group C,high school,free/reduced,completed,50,66,64,180
575,female,group E,high school,standard,none,74,81,71,226
576,male,group A,associate's degree,free/reduced,completed,40,55,53,148
577,male,group A,some college,standard,completed,61,51,52,164
578,female,group B,high school,standard,none,81,91,89,261
579,female,group B,some college,free/reduced,completed,48,56,58,162
580,female,group D,master's degree,standard,none,53,61,68,182
581,female,group D,some high school,standard,none,81,97,96,274
582,female,group E,some high school,standard,none,77,79,80,236
583,female,group D,bachelor's degree,free/reduced,none,63,73,78,214
584,female,group D,associate's degree,standard,completed,73,75,80,228
585,female,group D,some college,standard,none,69,77,77,223
586,female,group C,associate's degree,standard,none,65,76,76,217
587,female,group A,high school,standard,none,55,73,73,201
588,female,group C,bachelor's degree,free/reduced,none,44,63,62,169
589,female,group C,some college,standard,none,54,64,65,183
590,female,group A,some high school,standard,none,48,66,65,179
591,male,group C,some college,free/reduced,none,58,57,54,169
592,male,group A,some high school,standard,none,71,62,50,183
593,male,group E,bachelor's degree,standard,none,68,68,64,200
594,female,group E,high school,standard,none,74,76,73,223
595,female,group C,bachelor's degree,standard,completed,92,100,99,291
596,female,group C,bachelor's degree,standard,completed,56,79,72,207
597,male,group B,high school,free/reduced,none,30,24,15,69
598,male,group A,some high school,standard,none,53,54,48,155
599,female,group D,high school,standard,none,69,77,73,219
600,female,group D,some high school,standard,none,65,82,81,228
601,female,group D,master's degree,standard,none,54,60,63,177
602,female,group C,high school,standard,none,29,29,30,88
603,female,group E,some college,standard,none,76,78,80,234
604,male,group D,high school,free/reduced,none,60,57,51,168
605,male,group D,master's degree,free/reduced,completed,84,89,90,263
606,male,group C,some high school,standard,none,75,72,62,209
607,female,group C,associate's degree,standard,none,85,84,82,251
608,female,group C,master's degree,free/reduced,none,40,58,54,152
609,female,group E,some college,standard,none,61,64,62,187
610,female,group B,associate's degree,standard,none,58,63,65,186
611,male,group D,some college,free/reduced,completed,69,60,63,192
612,female,group C,some college,standard,none,58,59,66,183
613,male,group C,bachelor's degree,standard,completed,94,90,91,275
614,female,group C,associate's degree,standard,none,65,77,74,216
615,female,group A,associate's degree,standard,none,82,93,93,268
616,female,group C,high school,standard,none,60,68,72,200
617,female,group E,bachelor's degree,standard,none,37,45,38,120
618,male,group D,bachelor's degree,standard,none,88,78,83,249
619,male,group D,master's degree,standard,none,95,81,84,260
620,male,group C,associate's degree,free/reduced,completed,65,73,68,206
621,female,group C,high school,free/reduced,none,35,61,54,150
622,male,group B,bachelor's degree,free/reduced,none,62,63,56,181
623,male,group C,high school,free/reduced,completed,58,51,52,161
624,male,group A,some college,standard,completed,100,96,86,282
625,female,group E,bachelor's degree,free/reduced,none,61,58,62,181
626,male,group D,some college,standard,completed,100,97,99,296
627,male,group B,associate's degree,free/reduced,completed,69,70,63,202
628,male,group D,associate's degree,standard,none,61,48,46,155
629,male,group D,some college,free/reduced,none,49,57,46,152
630,female,group C,some high school,standard,completed,44,51,55,150
631,male,group D,some college,standard,none,67,64,70,201
632,male,group B,high school,standard,none,79,60,65,204
633,female,group B,bachelor's degree,standard,completed,66,74,81,221
634,female,group C,high school,standard,none,75,88,85,248
635,male,group D,some high school,standard,none,84,84,80,248
636,male,group A,high school,standard,none,71,74,64,209
637,female,group B,high school,free/reduced,completed,67,80,81,228
638,female,group D,some high school,standard,completed,80,92,88,260
639,male,group E,some college,standard,none,86,76,74,236
640,female,group D,associate's degree,standard,none,76,74,73,223
641,male,group D,high school,standard,none,41,52,51,144
642,female,group D,associate's degree,free/reduced,completed,74,88,90,252
643,female,group B,some high school,free/reduced,none,72,81,79,232
644,female,group E,high school,standard,completed,74,79,80,233
645,male,group B,high school,standard,none,70,65,60,195
646,female,group B,bachelor's degree,standard,completed,65,81,81,227
647,female,group D,associate's degree,standard,none,59,70,65,194
648,female,group E,high school,free/reduced,none,64,62,68,194
649,female,group B,high school,standard,none,50,53,55,158
650,female,group D,some college,standard,completed,69,79,81,229
651,male,group C,some high school,free/reduced,completed,51,56,53,160
652,female,group A,high school,standard,completed,68,80,76,224
653,female,group D,some college,standard,completed,85,86,98,269
654,female,group A,associate's degree,standard,completed,65,70,74,209
655,female,group B,some high school,standard,none,73,79,79,231
656,female,group B,some college,standard,none,62,67,67,196
657,male,group C,associate's degree,free/reduced,none,77,67,64,208
658,male,group D,some high school,standard,none,69,66,61,196
659,female,group D,associate's degree,free/reduced,none,43,60,58,161
660,male,group D,associate's degree,standard,none,90,87,85,262
661,male,group C,some college,free/reduced,none,74,77,73,224
662,male,group C,some high school,standard,none,73,66,63,202
663,female,group D,some college,free/reduced,none,55,71,69,195
664,female,group C,high school,standard,none,65,69,67,201
665,male,group D,associate's degree,standard,none,80,63,63,206
666,female,group C,some high school,free/reduced,completed,50,60,60,170
667,female,group C,some college,free/reduced,completed,63,73,71,207
668,female,group B,bachelor's degree,free/reduced,none,77,85,87,249
669,male,group C,some college,standard,none,73,74,61,208
670,male,group D,associate's degree,standard,completed,81,72,77,230
671,female,group C,high school,free/reduced,none,66,76,68,210
672,male,group D,associate's degree,free/reduced,none,52,57,50,159
673,female,group C,some college,standard,none,69,78,76,223
674,female,group C,associate's degree,standard,completed,65,84,84,233
675,female,group D,high school,standard,completed,69,77,78,224
676,female,group B,some college,standard,completed,50,64,66,180
677,female,group E,some college,standard,completed,73,78,76,227
678,female,group C,some high school,standard,completed,70,82,76,228
679,male,group D,associate's degree,free/reduced,none,81,75,78,234
680,male,group D,some college,free/reduced,none,63,61,60,184
681,female,group D,high school,standard,none,67,72,74,213
682,male,group B,high school,standard,none,60,68,60,188
683,male,group B,high school,standard,none,62,55,54,171
684,female,group C,some high school,free/reduced,completed,29,40,44,113
685,male,group B,some college,standard,completed,62,66,68,196
686,female,group E,master's degree,standard,completed,94,99,100,293
687,male,group E,some college,standard,completed,85,75,68,228
688,male,group D,associate's degree,free/reduced,none,77,78,73,228
689,male,group A,high school,free/reduced,none,53,58,44,155
690,male,group E,some college,free/reduced,none,93,90,83,266
691,female,group C,associate's degree,standard,none,49,53,53,155
692,female,group E,associate's degree,free/reduced,none,73,76,78,227
693,female,group C,bachelor's degree,free/reduced,completed,66,74,81,221
694,female,group D,associate's degree,standard,none,77,77,73,227
695,female,group C,some high school,standard,none,49,63,56,168
696,female,group D,some college,free/reduced,none,79,89,86,254
697,female,group C,associate's degree,standard,completed,75,82,90,247
698,female,group A,bachelor's degree,standard,none,59,72,70,201
699,female,group D,associate's degree,standard,completed,57,78,79,214
700,male,group C,high school,free/reduced,none,66,66,59,191
701,female,group E,bachelor's degree,standard,completed,79,81,82,242
702,female,group B,some high school,standard,none,57,67,72,196
703,male,group A,bachelor's degree,standard,completed,87,84,87,258
704,female,group D,some college,standard,none,63,64,67,194
705,female,group B,some high school,free/reduced,completed,59,63,64,186
706,male,group A,bachelor's degree,free/reduced,none,62,72,65,199
707,male,group D,high school,standard,none,46,34,36,116
708,male,group C,some college,standard,none,66,59,52,177
709,male,group D,high school,standard,none,89,87,79,255
710,female,group D,associate's degree,free/reduced,completed,42,61,58,161
711,male,group C,some college,standard,completed,93,84,90,267
712,female,group E,some high school,standard,completed,80,85,85,250
713,female,group D,some college,standard,none,98,100,99,297
714,male,group D,master's degree,standard,none,81,81,84,246
715,female,group B,some high school,standard,completed,60,70,74,204
716,female,group B,associate's degree,free/reduced,completed,76,94,87,257
717,male,group C,associate's degree,standard,completed,73,78,72,223
718,female,group C,associate's degree,standard,completed,96,96,99,291
719,female,group C,high school,standard,none,76,76,74,226
720,male,group E,associate's degree,free/reduced,completed,91,73,80,244
721,female,group C,some college,free/reduced,none,62,72,70,204
722,male,group D,some high school,free/reduced,completed,55,59,59,173
723,female,group B,some high school,free/reduced,completed,74,90,88,252
724,male,group C,high school,standard,none,50,48,42,140
725,male,group B,some college,standard,none,47,43,41,131
726,male,group E,some college,standard,completed,81,74,71,226
727,female,group E,associate's degree,standard,completed,65,75,77,217
728,male,group E,some high school,standard,completed,68,51,57,176
729,female,group D,high school,free/reduced,none,73,92,84,249
730,male,group C,some college,standard,none,53,39,37,129
731,female,group B,associate's degree,free/reduced,completed,68,77,80,225
732,male,group A,some high school,free/reduced,none,55,46,43,144
733,female,group C,some college,standard,completed,87,89,94,270
734,male,group D,some high school,standard,none,55,47,44,146
735,female,group E,some college,free/reduced,none,53,58,57,168
736,male,group C,master's degree,standard,none,67,57,59,183
737,male,group C,associate's degree,standard,none,92,79,84,255
738,female,group B,some college,free/reduced,completed,53,66,73,192
739,male,group D,associate's degree,standard,none,81,71,73,225
740,male,group C,high school,free/reduced,none,61,60,55,176
741,male,group D,bachelor's degree,standard,none,80,73,72,225
742,female,group A,associate's degree,free/reduced,none,37,57,56,150
743,female,group C,high school,standard,none,81,84,82,247
744,female,group C,associate's degree,standard,completed,59,73,72,204
745,male,group B,some college,free/reduced,none,55,55,47,157
746,male,group D,associate's degree,standard,none,72,79,74,225
747,male,group D,high school,standard,none,69,75,71,215
748,male,group C,some college,standard,none,69,64,68,201
749,female,group C,bachelor's degree,free/reduced,none,50,60,59,169
750,male,group B,some college,standard,completed,87,84,86,257
751,male,group D,some high school,standard,completed,71,69,68,208
752,male,group E,some college,standard,none,68,72,65,205
753,male,group C,master's degree,free/reduced,completed,79,77,75,231
754,female,group C,some high school,standard,completed,77,90,85,252
755,male,group C,associate's degree,free/reduced,none,58,55,53,166
756,female,group E,associate's degree,standard,none,84,95,92,271
757,male,group D,some college,standard,none,55,58,52,165
758,male,group E,bachelor's degree,free/reduced,completed,70,68,72,210
759,female,group D,some college,free/reduced,completed,52,59,65,176
760,male,group B,some college,standard,completed,69,77,77,223
761,female,group C,high school,free/reduced,none,53,72,64,189
762,female,group D,some high school,standard,none,48,58,54,160
763,male,group D,some high school,standard,completed,78,81,86,245
764,female,group B,high school,standard,none,62,62,63,187
765,male,group D,some college,standard,none,60,63,59,182
766,female,group B,high school,standard,none,74,72,72,218
767,female,group C,high school,standard,completed,58,75,77,210
768,male,group B,high school,standard,completed,76,62,60,198
769,female,group D,some high school,standard,none,68,71,75,214
770,male,group A,some college,free/reduced,none,58,60,57,175
771,male,group B,high school,standard,none,52,48,49,149
772,male,group D,bachelor's degree,standard,none,75,73,74,222
773,female,group B,some high school,free/reduced,completed,52,67,72,191
774,female,group C,bachelor's degree,free/reduced,none,62,78,79,219
775,male,group B,some college,standard,none,66,65,60,191
776,female,group B,some high school,free/reduced,none,49,58,55,162
777,female,group B,high school,standard,none,66,72,70,208
778,female,group C,some college,free/reduced,none,35,44,43,122
779,female,group A,some college,standard,completed,72,79,82,233
780,male,group E,associate's degree,standard,completed,94,85,82,261
781,female,group D,associate's degree,free/reduced,none,46,56,57,159
782,female,group B,master's degree,standard,none,77,90,84,251
783,female,group B,high school,free/reduced,completed,76,85,82,243
784,female,group C,associate's degree,standard,completed,52,59,62,173
785,male,group C,bachelor's degree,standard,completed,91,81,79,251
786,female,group B,some high school,standard,completed,32,51,44,127
787,female,group E,some high school,free/reduced,none,72,79,77,228
788,female,group B,some college,standard,none,19,38,32,89
789,male,group C,associate's degree,free/reduced,none,68,65,61,194
790,female,group C,master's degree,free/reduced,none,52,65,61,178
791,female,group B,high school,standard,none,48,62,60,170
792,female,group D,some college,free/reduced,none,60,66,70,196
793,male,group D,high school,free/reduced,none,66,74,69,209
794,male,group E,some high school,standard,completed,89,84,77,250
795,female,group B,high school,standard,none,42,52,51,145
796,female,group E,associate's degree,free/reduced,completed,57,68,73,198
797,male,group D,high school,standard,none,70,70,70,210
798,female,group E,associate's degree,free/reduced,none,70,84,81,235
799,male,group E,some college,standard,none,69,60,54,183
800,female,group C,associate's degree,standard,none,52,55,57,164
801,male,group C,some high school,standard,completed,67,73,68,208
802,male,group C,some high school,standard,completed,76,80,73,229
803,female,group E,associate's degree,standard,none,87,94,95,276
804,female,group B,some college,standard,none,82,85,87,254
805,female,group C,some college,standard,none,73,76,78,227
806,male,group A,some college,free/reduced,none,75,81,74,230
807,female,group D,some college,free/reduced,none,64,74,75,213
808,female,group E,high school,free/reduced,none,41,45,40,126
809,male,group C,high school,standard,none,90,75,69,234
810,male,group B,bachelor's degree,standard,none,59,54,51,164
811,male,group A,some high school,standard,none,51,31,36,118
812,male,group A,high school,free/reduced,none,45,47,49,141
813,female,group C,master's degree,standard,completed,54,64,67,185
814,male,group E,some high school,standard,completed,87,84,76,247
815,female,group C,high school,standard,none,72,80,83,235
816,male,group B,some high school,standard,completed,94,86,87,267
817,female,group A,bachelor's degree,standard,none,45,59,64,168
818,male,group D,bachelor's degree,free/reduced,completed,61,70,76,207
819,female,group B,high school,free/reduced,none,60,72,68,200
820,female,group C,some high school,standard,none,77,91,88,256
821,female,group A,some high school,standard,completed,85,90,92,267
822,female,group D,bachelor's degree,free/reduced,none,78,90,93,261
823,male,group E,some college,free/reduced,completed,49,52,51,152
824,female,group B,high school,free/reduced,none,71,87,82,240
825,female,group C,some high school,free/reduced,none,48,58,52,158
826,male,group C,high school,standard,none,62,67,58,187
827,female,group C,associate's degree,free/reduced,completed,56,68,70,194
828,female,group C,some high school,standard,none,65,69,76,210
829,female,group D,some high school,free/reduced,completed,69,86,81,236
830,male,group B,some high school,standard,none,68,54,53,175
831,female,group A,some college,free/reduced,none,61,60,57,178
832,female,group C,bachelor's degree,free/reduced,completed,74,86,89,249
833,male,group A,bachelor's degree,standard,none,64,60,58,182
834,female,group B,high school,standard,completed,77,82,89,248
835,male,group B,some college,standard,none,58,50,45,153
836,female,group C,high school,standard,completed,60,64,74,198
837,male,group E,high school,standard,none,73,64,57,194
838,female,group A,high school,standard,completed,75,82,79,236
839,male,group B,associate's degree,free/reduced,completed,58,57,53,168
840,female,group C,associate's degree,standard,none,66,77,73,216
841,female,group D,high school,free/reduced,none,39,52,46,137
842,male,group C,some high school,standard,none,64,58,51,173
843,female,group B,high school,free/reduced,completed,23,44,36,103
844,male,group B,some college,free/reduced,completed,74,77,76,227
845,female,group D,some high school,free/reduced,completed,40,65,64,169
846,male,group E,master's degree,standard,none,90,85,84,259
847,male,group C,master's degree,standard,completed,91,85,85,261
848,male,group D,high school,standard,none,64,54,50,168
849,female,group C,high school,standard,none,59,72,68,199
850,male,group D,associate's degree,standard,none,80,75,69,224
851,male,group C,master's degree,standard,none,71,67,67,205
852,female,group A,high school,standard,none,61,68,63,192
853,female,group E,some college,standard,none,87,85,93,265
854,male,group E,some high school,standard,none,82,67,61,210
855,male,group C,some high school,standard,none,62,64,55,181
856,female,group B,bachelor's degree,standard,none,97,97,96,290
857,male,group B,some college,free/reduced,none,75,68,65,208
858,female,group C,bachelor's degree,standard,none,65,79,81,225
859,male,group B,high school,standard,completed,52,49,46,147
860,male,group C,associate's degree,free/reduced,none,87,73,72,232
861,female,group C,associate's degree,standard,none,53,62,53,168
862,female,group E,master's degree,free/reduced,none,81,86,87,254
863,male,group D,bachelor's degree,free/reduced,completed,39,42,38,119
864,female,group C,some college,standard,completed,71,71,80,222
865,male,group C,associate's degree,standard,none,97,93,91,281
866,male,group D,some college,standard,completed,82,82,88,252
867,male,group C,high school,free/reduced,none,59,53,52,164
868,male,group B,associate's degree,standard,none,61,42,41,144
869,male,group E,associate's degree,free/reduced,completed,78,74,72,224
870,male,group C,associate's degree,free/reduced,none,49,51,51,151
871,male,group B,high school,standard,none,59,58,47,164
872,female,group C,some college,standard,completed,70,72,76,218
873,male,group B,associate's degree,standard,completed,82,84,78,244
874,male,group E,associate's degree,free/reduced,none,90,90,82,262
875,female,group C,bachelor's degree,free/reduced,none,43,62,61,166
876,male,group C,some college,free/reduced,none,80,64,66,210
877,male,group D,some college,standard,none,81,82,84,247
878,male,group C,some high school,standard,none,57,61,54,172
879,female,group D,some high school,standard,none,59,72,80,211
880,female,group D,associate's degree,standard,none,64,76,74,214
881,male,group C,bachelor's degree,standard,completed,63,64,66,193
882,female,group E,bachelor's degree,standard,completed,71,70,70,211
883,female,group B,high school,free/reduced,none,64,73,71,208
884,male,group D,bachelor's degree,free/reduced,none,55,46,44,145
885,female,group E,associate's degree,standard,none,51,51,54,156
886,female,group C,associate's degree,standard,completed,62,76,80,218
887,female,group E,associate's degree,standard,completed,93,100,95,288
888,male,group C,high school,free/reduced,none,54,72,59,185
889,female,group D,some college,free/reduced,none,69,65,74,208
890,male,group D,high school,free/reduced,none,44,51,48,143
891,female,group E,some college,standard,completed,86,85,91,262
892,female,group E,associate's degree,standard,none,85,92,85,262
893,female,group A,master's degree,free/reduced,none,50,67,73,190
894,male,group D,some high school,standard,completed,88,74,75,237
895,female,group E,associate's degree,standard,none,59,62,69,190
896,female,group E,some high school,free/reduced,none,32,34,38,104
897,male,group B,high school,free/reduced,none,36,29,27,92
898,female,group B,some high school,free/reduced,completed,63,78,79,220
899,male,group D,associate's degree,standard,completed,67,54,63,184
900,female,group D,some high school,standard,completed,65,78,82,225
901,male,group D,master's degree,standard,none,85,84,89,258
902,female,group C,master's degree,standard,none,73,78,74,225
903,female,group A,high school,free/reduced,completed,34,48,41,123
904,female,group D,bachelor's degree,free/reduced,completed,93,100,100,293
905,female,group D,some high school,free/reduced,none,67,84,84,235
906,male,group D,some college,standard,none,88,77,77,242
907,male,group B,high school,standard,none,57,48,51,156
908,female,group D,some college,standard,completed,79,84,91,254
909,female,group C,bachelor's degree,free/reduced,none,67,75,72,214
910,male,group E,bachelor's degree,standard,completed,70,64,70,204
911,male,group D,bachelor's degree,free/reduced,none,50,42,48,140
912,female,group A,some college,standard,none,69,84,82,235
913,female,group C,bachelor's degree,standard,completed,52,61,66,179
914,female,group C,bachelor's degree,free/reduced,completed,47,62,66,175
915,female,group B,associate's degree,free/reduced,none,46,61,55,162
916,female,group E,some college,standard,none,68,70,66,204
917,male,group E,bachelor's degree,standard,completed,100,100,100,300
918,female,group C,high school,standard,none,44,61,52,157
919,female,group C,associate's degree,standard,completed,57,77,80,214
920,male,group B,some college,standard,completed,91,96,91,278
921,male,group D,high school,free/reduced,none,69,70,67,206
922,female,group C,high school,free/reduced,none,35,53,46,134
923,male,group D,high school,standard,none,72,66,66,204
924,female,group B,associate's degree,free/reduced,none,54,65,65,184
925,male,group D,high school,free/reduced,none,74,70,69,213
926,male,group E,some high school,standard,completed,74,64,60,198
927,male,group E,associate's degree,free/reduced,none,64,56,52,172
928,female,group D,high school,free/reduced,completed,65,61,71,197
929,male,group E,associate's degree,free/reduced,completed,46,43,44,133
930,female,group C,some high school,free/reduced,none,48,56,51,155
931,male,group C,some college,free/reduced,completed,67,74,70,211
932,male,group D,some college,free/reduced,none,62,57,62,181
933,male,group D,associate's degree,free/reduced,completed,61,71,73,205
934,male,group C,bachelor's degree,free/reduced,completed,70,75,74,219
935,male,group C,associate's degree,standard,completed,98,87,90,275
936,male,group D,some college,free/reduced,none,70,63,58,191
937,male,group A,associate's degree,standard,none,67,57,53,177
938,female,group E,high school,free/reduced,none,57,58,57,172
939,male,group D,some college,standard,completed,85,81,85,251
940,male,group D,some high school,standard,completed,77,68,69,214
941,male,group C,master's degree,free/reduced,completed,72,66,72,210
942,female,group D,master's degree,standard,none,78,91,96,265
943,male,group C,high school,standard,none,81,66,64,211
944,male,group A,some high school,free/reduced,completed,61,62,61,184
945,female,group B,high school,standard,none,58,68,61,187
946,female,group C,associate's degree,standard,none,54,61,58,173
947,male,group B,high school,standard,none,82,82,80,244
948,female,group D,some college,free/reduced,none,49,58,60,167
949,male,group B,some high school,free/reduced,completed,49,50,52,151
950,female,group E,high school,free/reduced,completed,57,75,73,205
951,male,group E,high school,standard,none,94,73,71,238
952,female,group D,some college,standard,completed,75,77,83,235
953,female,group E,some high school,free/reduced,none,74,74,72,220
954,male,group C,high school,standard,completed,58,52,54,164
955,female,group C,some college,standard,none,62,69,69,200
956,male,group E,associate's degree,standard,none,72,57,62,191
957,male,group C,some college,standard,none,84,87,81,252
958,female,group D,master's degree,standard,none,92,100,100,292
959,female,group D,high school,standard,none,45,63,59,167
960,male,group C,high school,standard,none,75,81,71,227
961,female,group A,some college,standard,none,56,58,64,178
962,female,group D,some high school,free/reduced,none,48,54,53,155
963,female,group E,associate's degree,standard,none,100,100,100,300
964,female,group C,some high school,free/reduced,completed,65,76,75,216
965,male,group D,some college,standard,none,72,57,58,187
966,female,group D,some college,standard,none,62,70,72,204
967,male,group A,some high school,standard,completed,66,68,64,198
968,male,group C,some college,standard,none,63,63,60,186
969,female,group E,associate's degree,standard,none,68,76,67,211
970,female,group B,bachelor's degree,standard,none,75,84,80,239
971,female,group D,bachelor's degree,standard,none,89,100,100,289
972,male,group C,some high school,standard,completed,78,72,69,219
973,female,group A,high school,free/reduced,completed,53,50,60,163
974,female,group D,some college,free/reduced,none,49,65,61,175
975,female,group A,some college,standard,none,54,63,67,184
976,female,group C,some college,standard,completed,64,82,77,223
977,male,group B,some college,free/reduced,completed,60,62,60,182
978,male,group C,associate's degree,standard,none,62,65,58,185
979,male,group D,high school,standard,completed,55,41,48,144
980,female,group C,associate's degree,standard,none,91,95,94,280
981,female,group B,high school,free/reduced,none,8,24,23,55
982,male,group D,some high school,standard,none,81,78,78,237
983,male,group B,some high school,standard,completed,79,85,86,250
984,female,group A,some college,standard,completed,78,87,91,256
985,female,group C,some high school,standard,none,74,75,82,231
986,male,group A,high school,standard,none,57,51,54,162
987,female,group C,associate's degree,standard,none,40,59,51,150
988,male,group E,some high school,standard,completed,81,75,76,232
989,female,group A,some high school,free/reduced,none,44,45,45,134
990,female,group D,some college,free/reduced,completed,67,86,83,236
991,male,group E,high school,free/reduced,completed,86,81,75,242
992,female,group B,some high school,standard,completed,65,82,78,225
993,female,group D,associate's degree,free/reduced,none,55,76,76,207
994,female,group D,bachelor's degree,free/reduced,none,62,72,74,208
995,male,group A,high school,standard,none,63,63,62,188
996,female,group E,master's degree,standard,completed,88,99,95,282
997,male,group C,high school,free/reduced,none,62,55,55,172
998,female,group C,high school,free/reduced,completed,59,71,65,195
999,female,group D,some college,standard,completed,68,78,77,223
1000,female,group D,some college,free/reduced,none,77,86,86,249
